[
    {
        "id": 1,
        "grid": [
            [0,0,0,0,0,0,0,0,0,0,0,0,0,0,0],
            [0,0,0,0,0,0,0,0,0,0,0,0,0,0,0],
            [0,0,0,0,0,0,0,0,0,0,0,0,0,0,0],
            [0,0,0,0,0,0,0,0,0,0,0,0,0,0,0],
            [0,0,0,0,0,0,0,0,0,0,0,0,0,0,0],
            [0,0,1,0,0,0,0,0,0,0,1,0,0,0,0],
            [0,0,0,0,0,0,0,0,0,0,0,0,0,0,0],
            [0,0,0,0,0,0,0,0,0,0,0,0,0,0,0],
            [0,0,0,0,0,0,0,0,0,0,0,0,0,0,0],
            [0,0,0,0,0,1,0,1,0,0,0,0,0,0,0],
            [0,0,0,0,0,0,0,0,0,0,0,0,0,0,0],
            [0,0,0,0,0,0,0,0,0,0,0,0,0,0,0],
            [0,0,0,0,0,0,0,0,0,0,0,0,0,0,0],
            [0,0,0,0,0,0,0,0,0,0,0,0,0,0,0],
            [0,0,0,0,0,0,0,0,0,0,0,0,0,0,0]
        ]
    },
    {
        "id": 2,
        "grid": [
            [0,0,0,0,0,0,0,0,0,0,0,0,0,0,0],
            [0,0,0,0,0,0,0,0,0,0,0,0,0,0,0],
            [0,0,0,0,0,0,0,0,0,0,0,0,0,0,0],
            [0,0,0,0,0,0,0,0,0,0,0,0,0,0,0],
            [0,0,0,0,0,0,0,0,0,1,0,0,0,0,0],
            [0,0,0,1,0,0,0,0,0,0,0,0,0,0,0],
            [0,0,0,0,0,0,0,0,0,0,0,0,0,0,0],
            [0,0,0,0,0,0,0,0,1,0,0,0,0,0,0],
            [0,0,0,0,0,0,0,0,0,0,0,0,0,0,0],
            [0,0,0,0,0,0,0,0,0,0,0,0,0,0,0],
            [0,0,0,0,0,0,0,0,0,0,0,0,0,0,0],
            [0,0,0,0,0,1,0,0,0,0,0,0,0,0,0],
            [0,0,0,0,0,0,0,0,0,0,0,0,0,0,0],
            [0,0,0,0,0,0,0,0,0,0,0,0,0,0,0],
            [0,0,0,0,0,0,0,0,0,0,0,0,0,0,0]
        ]
    },
    {
        "id": 3,
        "grid": [
            [0,0,0,0,0,0,0,0,0,0,0,0,0,0,0],
            [0,0,0,0,0,0,0,0,0,0,0,0,0,0,0],
            [0,0,0,0,0,0,0,0,0,0,0,0,0,0,0],
            [0,0,0,0,0,0,0,0,0,0,0,0,0,0,0],
            [0,0,0,0,0,0,0,0,0,0,0,0,0,0,0],
            [0,0,0,0,0,0,0,0,1,0,0,0,0,0,0],
            [0,0,0,0,0,0,0,0,0,0,0,0,0,0,0],
            [0,0,0,0,0,0,0,0,0,0,0,0,0,0,0],
            [0,0,0,0,0,0,0,0,1,0,0,0,0,0,0],
            [0,0,0,0,0,1,0,0,0,0,0,0,0,0,0],
            [0,0,0,0,0,0,0,0,0,0,0,0,0,0,0],
            [0,0,0,0,0,0,0,0,0,0,0,0,0,0,0],
            [0,0,0,0,0,0,0,0,0,0,0,0,0,0,0],
            [0,0,0,0,0,0,0,0,0,0,0,0,0,0,0],
            [0,0,0,0,0,0,0,0,0,0,0,0,0,0,0]
        ]
    },
    {
        "id": 4,
        "grid": [
            [0,0,0,0,0,0,0,0,0,0,0,0,0,0,0],
            [0,0,0,0,0,0,0,0,0,0,0,0,0,0,0],
            [0,0,0,0,0,0,0,0,0,0,0,0,0,0,0],
            [0,0,0,0,0,1,0,0,0,0,0,0,0,0,0],
            [0,0,0,0,0,0,0,0,0,0,0,0,0,0,0],
            [0,0,0,0,0,0,0,0,0,0,1,0,0,0,0],
            [0,0,0,1,0,0,0,0,0,0,0,0,0,0,0],
            [0,0,0,0,0,0,0,0,0,0,0,0,0,0,0],
            [0,0,0,0,0,0,0,0,0,0,0,0,0,0,0],
            [0,0,0,0,0,0,0,0,0,1,0,0,0,0,0],
            [0,0,0,0,0,1,0,0,0,0,0,0,0,0,0],
            [0,0,0,0,0,0,0,0,0,0,0,0,0,0,0],
            [0,0,0,0,0,0,0,0,0,0,0,0,0,0,0],
            [0,0,1,0,0,0,0,0,0,0,1,0,0,0,0],
            [0,0,0,0,0,0,0,0,0,0,0,0,0,0,1]
        ]
    },
    {
        "id": 5,
        "grid": [
            [0,0,0,0,0,0,0,0,0,0,0,0,0,0,0],
            [0,0,0,0,0,0,0,0,0,0,0,0,0,0,0],
            [0,0,0,0,0,0,0,0,0,0,0,0,0,0,0],
            [0,0,0,0,0,1,0,0,0,0,0,0,0,0,0],
            [0,0,0,0,0,0,0,0,0,0,0,0,0,0,0],
            [0,0,0,0,0,0,0,0,0,0,1,0,0,0,0],
            [0,0,0,1,0,0,0,0,0,0,0,0,0,0,0],
            [0,0,0,0,0,0,0,0,0,0,0,0,0,0,0],
            [0,0,0,0,0,0,0,0,0,0,0,0,0,0,0],
            [0,0,0,0,0,0,0,0,0,1,0,0,0,0,0],
            [0,0,0,0,0,1,0,0,0,0,0,0,0,0,0],
            [0,0,0,0,0,0,0,0,0,0,0,0,0,0,0],
            [0,0,0,0,0,0,0,0,0,0,0,0,0,0,0],
            [0,0,1,0,0,0,0,0,0,0,1,0,0,0,0],
            [0,0,0,0,0,0,0,0,0,0,0,0,0,0,1]
        ]
    },
    {
        "id": 6,
        "grid": [
            [0,0,0,0,0,0,0,0,0,0,0,0,0,0,0],
            [0,0,0,0,0,0,0,0,0,0,0,0,0,0,0],
            [0,0,0,0,0,0,0,0,0,0,0,0,0,0,0],
            [0,0,1,1,1,1,0,0,0,0,0,0,0,0,0],
            [0,0,1,0,0,1,0,0,0,0,0,0,0,0,0],
            [0,1,1,0,0,1,0,0,0,0,0,0,0,0,0],
            [0,1,0,0,1,1,0,1,0,0,0,1,0,0,0],
            [0,1,0,1,1,0,0,1,0,0,0,1,0,0,0],
            [0,0,1,1,0,1,1,0,0,0,0,1,0,0,0],
            [0,0,1,1,1,1,1,0,0,0,0,1,0,0,0],
            [0,0,0,1,1,0,0,0,0,0,0,1,0,0,0],
            [0,0,0,0,0,0,1,0,1,0,0,1,0,0,0],
            [0,0,0,0,0,0,0,0,0,0,1,0,0,1,0],
            [0,0,0,0,0,0,0,0,0,0,0,1,0,1,1],
            [0,0,0,0,0,0,0,0,0,1,1,0,1,1,0]
        ]
    },
    {
        "id": 7,
        "grid": [
            [0,0,0,0,0,0,0,0,0,0,0,0,0,0,0],
            [0,0,0,0,0,0,0,0,0,0,0,0,0,0,0],
            [0,0,0,0,0,0,1,1,0,0,0,0,0,0,0],
            [0,0,0,0,0,0,1,0,1,0,0,0,0,0,0],
            [0,0,0,0,0,1,0,0,0,1,0,0,0,0,0],
            [0,0,0,0,0,1,0,0,0,1,1,0,0,0,0],
            [0,0,0,0,0,1,0,0,0,0,1,1,0,0,0],
            [0,0,0,0,0,1,0,0,0,0,1,1,0,0,0],
            [0,0,0,0,0,1,0,0,0,0,1,1,0,0,0],
            [0,0,0,0,0,1,0,0,0,1,0,1,1,0,0],
            [0,0,1,1,1,1,1,0,0,1,0,0,0,1,1],
            [0,0,1,0,0,0,0,1,1,1,0,0,0,0,1],
            [0,0,1,0,0,0,0,0,1,0,0,0,0,1,1],
            [0,0,1,1,0,0,0,1,1,1,0,1,1,1,0],
            [0,0,0,1,1,1,1,1,0,1,1,1,0,0,0]
        ]
    },
    {
        "id": 8,
        "grid": [
            [0,0,0,0,0,0,0,0,0,0,0,0,0,0,0],
            [0,0,0,0,0,0,0,0,0,0,0,0,0,0,0],
            [0,0,0,0,0,0,0,0,0,0,0,1,0,0,0],
            [0,0,0,0,0,0,0,0,0,0,0,1,0,0,0],
            [0,0,0,0,0,0,0,0,0,0,1,1,0,0,0],
            [0,0,0,0,0,1,0,1,0,0,1,1,0,0,0],
            [0,0,0,0,0,0,0,0,0,1,1,1,1,0,0],
            [0,0,0,0,0,0,0,0,0,1,1,0,0,0,0],
            [0,0,0,0,0,0,0,0,1,1,0,0,0,0,0],
            [0,0,0,0,0,0,0,0,1,1,1,0,0,0,0],
            [0,0,0,0,1,1,1,1,1,1,0,0,0,0,0],
            [0,0,0,0,1,1,1,1,1,0,0,0,0,0,0],
            [0,0,0,0,0,1,1,1,0,0,0,0,0,0,0],
            [0,0,0,0,0,0,0,0,0,0,0,0,0,0,0],
            [0,0,0,0,0,0,0,0,0,0,0,0,0,0,0]
        ]
    },
    {
        "id": 9,
        "grid": [
            [0,0,0,0,0,0,0,0,0,0,0,0,0,0,0],
            [0,0,0,0,0,0,1,0,0,0,0,0,0,0,0],
            [0,0,0,0,0,1,1,0,0,0,0,0,0,0,0],
            [0,0,0,0,0,1,1,0,0,0,0,0,0,0,0],
            [0,0,0,0,1,1,1,0,0,0,0,0,0,0,0],
            [0,0,0,0,1,1,1,1,0,0,0,0,0,0,0],
            [0,0,0,0,1,0,1,1,0,0,0,0,0,0,0],
            [0,0,0,0,1,0,0,1,0,0,0,0,0,0,0],
            [0,0,0,0,1,0,0,1,0,0,0,0,0,0,0],
            [0,0,0,0,1,0,0,1,0,0,0,0,0,0,0],
            [0,0,0,1,1,0,1,1,1,1,0,0,0,0,0],
            [0,0,1,1,1,1,1,0,0,1,0,0,0,0,0],
            [0,0,1,1,1,1,1,0,0,1,0,0,0,0,0],
            [0,0,1,1,1,1,1,0,0,1,0,0,0,0,0],
            [0,0,0,1,1,1,1,1,1,1,0,0,0,0,0]
        ]
    },
    {
        "id": 10,
        "grid": [
            [0,0,0,0,0,0,0,0,0,0,0,0,0,0,0],
            [0,1,1,0,0,0,0,0,0,0,0,0,0,0,0],
            [0,0,1,0,0,0,0,0,0,0,0,0,0,0,0],
            [0,0,1,1,0,0,0,0,0,0,0,0,0,0,0],
            [0,0,1,1,1,1,1,0,0,0,0,0,0,0,0],
            [0,0,0,1,1,1,1,1,1,0,0,0,0,0,0],
            [0,1,1,0,1,1,1,0,0,1,1,0,1,1,0],
            [0,0,0,1,1,1,1,1,1,1,1,1,1,0,0],
            [0,0,1,1,1,1,1,1,1,1,1,0,0,0,0],
            [0,0,1,1,1,1,1,1,0,1,1,0,0,0,0],
            [0,0,0,0,1,0,0,1,1,1,1,0,0,0,0],
            [0,0,0,0,0,0,1,1,0,1,1,1,0,0,0],
            [0,0,0,0,0,0,0,0,1,1,1,0,1,0,0],
            [0,0,0,0,0,0,0,0,0,0,0,0,1,1,0],
            [0,0,0,0,0,0,0,0,0,0,0,0,0,1,1]
        ]
    }
]